0000000000000000000000000000000000000000000000000000
0000000000000000000000000000000000000000000000000000
0111111111113111181111111001111111111111111811111110
0100010000001000000010001111000100000010000000100010
0100010000000000000010001003000100000000000000100010
0100010000000000000010000001000100000000000000100000
0111110000000000000011111001111100000000000000111110
0111110000000000000011111001111100000000000000111110
0100010001131111000010001001000100011111110000100010
0100010001001001000010001001000100010010010000100010
0100010001001001000010001001000100010010010000100010
0111111711112111111111111111111117111111111111111110
0000000000000000000000000000000000000000000000000000
0000000000000000000000000000000000000000000000000000