11111111111111111111111111111111111111111111111111
11111111111111111111111111111111111111111111111111
10000000000000000000000011000000000000000000000001
10111011111101111110111000011101111110111111011101
10111011111121111110111011011101111110111111011101
10111011110000011110111011011101111000001111011101
10000011111111111110000011000001111111111111000001
10000011111111111110000011000001111111111111000001
10111011100000001110111011011101110000000111011101
10111011101101101110111011011101110110110111011101
10111011101101101110111011011101110110110111011101
10000000000000000000000000000000000000000000000001
11111111111111111111111111111111111111111111111111
11111111111111111111111111111111111111111111111111