00000000000000000000000000000000000000000000000000
00000000000000000000000000000000000000000000000000
01111111111131111811111100111111111111111181111110
01000100000010000001000111100010000001000000100010
01000100000000000001000100300010000000000000100010
01000100000000000001000000100010000000000000100000
01111100000000000001111100111110000000000000111110
01111100000000000001111100111110000000000000111110
01000100011311110001000100100010001111111000100010
01000100010010010001000100100010001001001000100010
01000100010010010001000100100010001001001000100010
01111117111121111111111111111111711111111111111110
00000000000000000000000000000000000000000000000000
00000000000000000000000000000000000000000000000000