1111111111111111111111111111111111111111111111111111
1111111111111111111111111111111111111111111111111111
1000000000000000000000000110000000000000000000000001
1011101111110111111101110000111011111101111111011101
1011101111112111111101110110111011111101111111011101
1011101111000001111101110110111011110000011111011101
1000001111111111111100000110000011111111111111000001
1000001111111111111100000110000011111111111111000001
1011101110000000111101110110111011100000001111011101
1011101110110110111101110110111011101101101111011101
1011101110110110111101110110111011101101101111011101
1000000000000000000000000000000000000000000000000001
1111111111111111111111111111111111111111111111111111
1111111111111111111111111111111111111111111111111111