000000000000000000000000000
011111111111111118111111110
010001000000100000000100010
010001000000000000000100010
010001000065340000000100010
011111000000000000000111110
010001000111111100000100010
010001000100100100000100010
011111171111121111111111110
000000000000000000000000000