111111111111111111111111111
100000000000000000000000001
101111111111111111111111101
101111111111111111111111101
101111111111111111111111101
101111111111111111111111101
101111111111111111111111101
101111111111111111111111101
100000000000000000000000001
111111111111111111111111111