000000000000000000000000000
011111111111111118111111110
010000000000000000000000010
010000000000000000000000010
050000000000000000000000060
010000000000000000000000010
030000000000000000000000040
010000000000000000000000010
011111171111121111111111110
000000000000000000000000000