111111111111111111111111111
100000000000000000000000001
101110111111011111111011101
101110111111211111111011101
101110111100000111111011101
100000111111111111111000001
101110111000000011111011101
101110111011011011111011101
100000000000000000000000001
111111111111111111111111111