11111111111111111111111111
11111111111111111111111111
10000000000000000000000001
10111011111101111111011101
10111011111121111111011101
10111011110000011111011101
10000011111111111111000001
10000011111111111111000001
10111011100000001111011101
10111011101101101111011101
10111011101101101111011101
10000000000000000000000001
11111111111111111111111111
11111111111111111111111111