00000000000000000000000000
00000000000000000000000000
01111111111131111811111110
01000100000010000000100010
01000100000000000000100010
01000100000000000000100000
01111100000000000000111110
01111100000000000000111110
01000100011111110000100010
01000100010010010000100010
01000100010010010000100010
01111117111121111111111110
00000000000000000000000000
00000000000000000000000000